NO assets/flower.xpm42
SO assets/sun.xpm42
WE assets/purple.xpm42
EA assets/sky.xpm42
F 0,40,0
C 225,30,0
11111111 1111111 111111111111
