NO assets/flower.xpm42
SO assets/sun.xpm42
WE assets/purple.xpm42
EA assets/sky.xpm42

F 80,0,80
C 80,80,80


        1111111111111111111111111
        1000000000110000000000001
        101100000111000000N000001
        1001000000000000000000001
111111111011000001110000000000001
100000000011000001110111111111111
111101111111110111000000100011111
11110111111111011101010010001
11000000110101011100000010001
100000000000000011000000010001
10000000000000001101010010101
1010000111010101111101111010111
11110111 1110101 101111010001
11111111 1111111 111111111111
