NO assets/sky.xpm42
SO assets/sun.xpm42
WE assets/flower.xpm42
EA assets/purple.xpm42

F 0,40,0
C 225,30,0

DDDDDDDDDDDDDDDDDDDDDDDD
D0000000000000000000000D
D000000N000000000000000D
D0000000000000000000000D
D0D0DD0000DD00000000000D
D0000D00000000000000000D
D0DDD0D0DDDD00000000000D
D00000D0000000000000000D
D0000D0D000000000000000D
D000000000000D000000000D
D0000000000000000000000D
D0000000000000000000000D
D0000000000000000000000D
DDDDDDDDDDDDDDDDDDDDDDDD
