NO ../assets/sky.xpm
SO ../assets/sun.xpm
WE ../assets/flower.xpm
EA ../assets/purple.xpm

F 0,40,0
C 225,30,0

111111111111111111111111
1000000N0000000000000001
100000000000000000000001
100000000000000000000001
101011000011000000000001
100001000000000000000001
101110101111000000000001
100000100000000000000001
100001010000000000000001
100000000000010000000001
100000000000000000000001
100000000000000000000001
100000000000000000000001
111111111111111111111111
