NO ../assets/sky.xpm
SO ../assets/sun.xpm
WE ../assets/flower.xpm
EA ../assets/purple.xpm

F 0,40,0
C 225,30,0

111111111111111111111111
100000000000000000000001
100000000000000000000001
100000000000000000000001
101010101111000000000001
100000000000000000000001
101110001111000000000001
100000100000000000000001
10000101N000000000000001
100000000000000000000001
100000000000000000000001
100000000000000000000001
100000000000000000000001
111111111111111111111111
