NO assets/sky.xpm42
SO assets/sun.xpm42
WE assets/flower.xpm42
EA assets/purple.xpm42

F 0,40,0
C 225,30,0

111111111111111111111111
100000000000000000000001
1000000N0000000000000001
100000000000000000000001
101011000011000000000001
100001000000000000000001
101110101111000000000001
100000100000000000000001
100001010000000000000001
100000000000010000000001
100000000000000000000001
10000000D000000000000001
100000000000000000000001
111111111111111111111111
