NO assets/flower.xpm42
SO assets/sun.xpm42
WE assets/purple.xpm42
EA assets/sky.xpm42

F 0,40,0
C 225,30,0


        1111111111111111111111111
        1000000000110000000000001
        1011000001110000000000001
        100100000DDD0000000000001
111111111011000001110000000000001
10000000001100000111D111111111111
11110111111111011100000010001
11110111111111011101010010001
11000000110101011100000010001
10000000000000001100N00010001
10000000000000001101010010101
1100000111010101111101111010111
11110111 1110101 101111010001
11111111 1111111 111111111111
